Test 2 fail because 2 player
8 8
++++....
+..+....
+..+++++
+...W..+
++W*+#.+
+...+..+
+...++++
+++++...