Level 07
7 8
.++++++.
++....+.
+..++.++
+.#*#*.+
++.+...+
.+.W.+++
.+++++..
