Level 14
8 8
.++++++.
.+....+.
++.+..+.
+*G+..+.
+*.+.+++
+W##...+
+..+...+
++++++++
