Level 11
8 8
++++++++
+...+..+
+..*...+
++#++..+
+.W*+..+
+.#....+
+++++..+
....++++
