Level 08
8 8
..++++..
..+..+++
+++#*W.+
+...+..+
+..#*.++
+..+..+.
++++..+.
...++++.
