Level 09
7 8 
..++++++
..+....+
+++....+
+...+*++
+..##*+.
++...W+.
.++++++.
