Level 13
6 9
...++++++
++++.W..+
+...###.+
+.+..+.++
+***...+.
++++++++.
